1  1   1  1  1  1  1  1  1  1  1  1  1  1  1  1  1  1  1  1  1
1  1   1  1  1  1  1  1  1  1  1  1  1  1  1  1  1  1  1  1  1
1  1   1  1  1  1  1  1  1  1  1  1  1  1  1  1  1  1  1  1  1
1  1  81 81 81 81 41 41 41 41 41 41 41 41 41 41 81 81 81 81  1
1  1  81 71 71 81 31 31 31 31 31 31 31 31 31 31 81 71 71 81  1
1  1  81 71 71 81 31 31 31 31 31 31 31 31 31 31 81 71 71 81  1
1  1  81 71 71 81  1 71 95 71  1  1  1  1  1  1 81 71 71 81  1
1  1  81 81 81 81 81 94 151 95 1  1  1  1  1  1 81 81 81 81  1 
1  1  31 31  1  1  1 71 95 71  1  1  1  1  1 11 21 11 31 31  1
1  1  31 31  1  1  1  1  1  1  1  1  1  1  1 11 21 11 31 31  1
1  1  31 31  1  1  1  1  1  1  1  1  1  1  1 11 21 11 31 31  1
1  1  31 31  1  1  1  1  1  1  1  1  1  1  1 11 21 11 31 31  1
1  1  31 31  1  1  1  1  1  1  1  1  1  1  1  1  1  1 31 31  1
1  1  31 31  1  1  1  1  1  1  1  1  1  1  1  1  1  1 31 31  1
1  1  31 31  1  1  1  1  1  1  1  1  1  1  1  1  1  1 31 31  1
1  1  81 81 81 81  1  1  1  1  1  1  1  1  1  1 81 81 81 81  1
1  1  81 71 71 81  1  1  1  1  1  1  1  1  1  1 81 71 71 81  1
1  1  81 71 71 81 31 31 31 31 31 31 31 31 31 31 81 71 71 81  1
1  1  81 71 71 81 31 31 31 31 31 31 31 31 31 31 81 71 71 81  1
1  1  81 81 81 81 41 41 71 11 11 11 71 41 41 41 81 81 81 81  1
1  1   1  1  1  1  1  1  1 11 11 11  1  1  1  1  1  1  1  3  1
1  1   1  1  1  1  1  1  1 11 11 11  1  1  1  1  1  1  1  1  1
1  1 -11 -21 -9 1  1  1  1 11 11 11  1  1  1  1  1  1  1  1  1
1  1 -19 -9 -9 -9 -9 -9 -9 11 11 11 -9 -9 -9 -9 -9  1  1  1  1
1  1   1  1  1 -9  1 -9  1 11 11 11  1  1  1  1  1  1  1  1  1
1  1   1  1  1  1  1  1  1 11 11 11  1  1  1  1  1  1  1  1  1
1  1   1  1  1  1  1  1  1 11 11 11  1  1  1  1  1  1  1  1  1
