10 50 14 7  12  19 21 42 18 50
20 21 41 30 27 100 1  80 50 10
74 52 98 30 14 74 30 -15 10 74
96 47 52 0 75 -30 10  2  7  84
10 28 83 4 52   1 148 0  0  4
10 50 14 7  12  19 21 42 18 50
20 21 41 30 27 100 1  80 50 10
74 52 98 30 14 74 30 -15 10 74
96 47 52 0 75 -30 10  2  7  84
10 28 83 4 52   1 148 0  0  4