1 1  1  1  1 1   1  1 1  1  1  1 1 1
1 1  1  1  1 1   1  1 1  1  1  1 1 1
1 1 21 21 21 1   1  1 1 21 21 21 1 1
1 1 21 21 21 1   1  1 1 21 21 21 1 1
1 1 21 21 21 1   1  1 1 21 21 21 1 1
1 1 1  1  1 1  11 11 1  1  1  1 1 1  
1 1 1  1  1 1  21 21 1  1  1  1 1 1
1 1 1  1  1 1  31 31 1  1  1  1 1 1
1 1 1  1  1 1  31 31 1  1  1  1 1 1
1 1 1  1  1 11 31 31 11 1  1  1 1 1
1 1 1  1 11 21 31 31 21 11 1  1 1 1
1 1 1  1  1 11 21 21 11 1  1  1 1 1
1 1 1  1  1  1 11 11 1  1  1  1 1 1
1 1  1  1  1  1  1  1 1  1  1 1 1
1 1 -21 -21 1 1  1  1  1 1 -21 -21 1 1
1 1 1  -21 -21 1 1 1 1 -21 -21 1 1 1
1 1 1  1 -21 -21 -21 -21 -21 -21  1 1 1 1
1 1 1  1 -21 -21 -21 -21 -21 -21  1 1 1 1
1 1 1  1  1   1   1   1   1   1   1 1 1 1
1 1 1  1  1   1    1   1  1   1   1 1 1 1