10 50 40 20 90 50 10 34 84 75 12 57 63 24 8 75 32 90 14 77 62 50 30 145 7 3 150 1
10 50 40 20 90 50 10 34 84 75 12 57 63 24 8 75 32 90 14 77 62 50 30 145 7 3 150 1
10 50 40 20 90 50 10 34 84 75 12 57 63 24 8 75 32 90 14 77 62 50 30 145 7 3 150 1
10 50 40 20 90 50 10 34 84 75 12 57 63 24 8 75 32 90 14 77 62 50 30 145 7 3 150 1
10 50 40 20 90 50 10 34 84 75 12 57 63 24 8 75 32 90 14 77 62 50 30 145 7 3 150 1
10 50 40 20 90 50 10 34 84 75 12 57 63 24 8 75 32 90 14 77 62 50 30 145 7 3 150 1
10 50 40 20 90 50 10 34 84 75 12 57 63 24 8 75 32 90 14 77 62 50 30 145 7 3 150 1
10 50 40 20 90 50 10 34 84 75 12 57 63 24 8 75 32 90 14 77 62 50 30 145 7 3 150 1
10 50 40 20 90 50 10 34 84 75 12 57 63 24 8 75 32 90 14 77 62 50 30 145 7 3 150 1
10 50 40 20 90 50 10 34 84 75 0 57 63 24 8 75 32 90 14 77 62 50 30 145 7 3 150 1
10 50 40 20 90 50 10 34 84 75 12 57 63 24 8 75 32 90 14 77 62 50 30 145 7 3 150 1
10 50 40 20 90 50 10 34 84 75 12 57 63 24 8 75 32 90 14 77 62 50 30 145 7 3 150 1
10 50 40 20 90 50 10 0 84 75 12 57 63 24 8 75 32 90 14 77 62 50 30 145 7 3 150 1
10 50 40 20 90 50 10 34 84 75 12 57 63 24 8 75 32 90 14 77 62 50 30 145 7 3 150 1
10 50 40 20 90 50 10 34 84 75 12 57 63 24 8 75 32 90 14 77 62 50 30 145 7 3 150 1
10 50 40 20 90 50 10 34 84 75 12 57 63 24 8 75 32 90 14 77 62 50 30 145 7 3 150 1
10 50 40 20 90 50 10 34 84 75 12 57 63 24 8 75 32 90 14 77 62 50 30 145 7 3 150 1
10 50 40 20 90 50 10 34 84 75 12 57 63 24 8 75 32 90 14 77 62 50 30 145 7 3 150 1
10 50 40 20 90 50 10 34 84 75 12 57 63 24 8 75 32 90 14 77 62 50 30 145 7 3 150 1
10 50 40 20 90 50 10 34 84 75 12 57 63 24 8 75 32 90 14 77 62 50 30 145 7 3 150 1
10 50 40 20 90 50 10 34 84 75 12 57 63 24 8 75 32 90 14 77 62 50 30 145 7 3 150 1
10 50 40 20 90 50 10 34 84 75 12 57 63 24 8 75 32 90 14 77 62 50 30 145 7 3 150 1
10 50 40 20 90 50 10 34 84 75 12 57 63 24 8 75 32 90 14 77 62 50 30 145 7 3 150 1
10 50 40 20 90 50 10 34 84 75 12 57 63 24 8 75 32 90 14 77 62 50 30 145 7 3 150 1
10 50 40 20 90 50 10 34 84 75 12 57 63 24 8 75 32 90 14 77 62 50 30 145 7 3 150 1
10 50 40 20 90 50 10 34 84 75 12 57 63 24 8 75 32 90 14 77 62 50 30 145 7 3 150 1
10 50 40 20 90 50 10 34 84 75 12 57 63 24 8 75 32 90 14 77 62 50 30 145 7 3 150 1
10 50 40 20 90 50 10 34 84 75 12 57 63 24 8 75 32 90 0 77 62 50 30 145 7 3 150 1
10 50 40 20 90 50 10 34 84 75 12 57 63 24 8 75 32 90 14 77 62 50 30 145 7 3 150 1
10 50 40 20 90 50 10 34 84 75 12 57 63 24 8 75 32 90 14 77 62 50 30 145 7 3 150 0
10 50 40 20 90 50 10 34 84 75 12 57 63 24 8 75 32 90 14 77 62 50 30 145 7 3 150 1
10 50 40 20 90 50 10 34 84 75 12 57 63 24 8 75 32 90 14 77 62 50 30 145 7 3 150 1