400	320	250	320	150	20	14	23
380	300	199	150	50	24	9	1
290	150	75	100	34	1	7	15
168	150	81	10	24	2	5	4
99	84	76	24	52	21	10	1
50	12	35	41	11	1	12	1
