30 10 100 20 25 30 15 2
10 30 320 30 25 35 10 0
10 10 230 32 23 20 10 5
20 25 51 30 20 10 20 0
10 20 20 30 20 15 1  1
5  1  1  1  1  1  1  1
1  1  1  1  1  1  1  1