1    1    1    1    1    1    1    1    1    1    1    1    1    1    1     1    1    1
1    1    1    1    1    1    1    1    1    1    1    1    1    1    1     1    1    1
1    1  -25  -25  -25  -25  -25  -25 -25   -25  -25  -25  -25  -25  -25   -25    1    1
1    1  -25  -25  -25  -25  -25  -25 -25   -25  -25  -25  -25  -25  -25   -25    1    1
1    1  -25  -25  111  111   51   51  51    51   51   51  111  111  -25   -25    1    1
1    1  -25  -25  111  111   51   51  51    51   51   51  111  111  -25   -25    1    1
1    1  -25  -25  111  111   51   51  51    51   51   51  111  111  -25   -25    1    1
1    1  -25  -25   51  51    1    1   1     1    1    1   51   51  -25   -25    1    1
1    1  -25  -25   51  51    1    1   1     1    1    1   51   51  -25   -25    1    1
1    1  -25  -25   51  51    1    1   1     1    1    1   51   51  -25   -25    1    1
1    1  -25  -25   51  51    1    1   1     1    1    1   51   51  -25   -25    1    1
1    1  -25  -25   51  51    1    1   1     1    1    1   51   51  -25   -25    1    1
1    1  -25  -25   51  51    1    1   1     1    1    1   51   51  -25   -25    1    1
1    1  -25  -25   51  51    1    1   1     1    1    1   51   51  -25   -25    1    1
1    1  -25  -25   51  51    1    1   1     1    1    1   51   51  -25   -25    1    1
1    1  -25  -25  111  111   51   51   1     1   51   51  111  111  -25   -25    1    1
1    1  -25  -25  111  111   51   51   1     1   51   51  111  111  -25   -25    1    1
1    1  -25  -25  111  111   51   51   1     1   51   51  111  111  -25   -25    1    1
1    1  -25  -25  -25  -25  -25  -25   5     5  -25  -25  -25  -25  -25   -25    1    1
1    1  -25  -25  -25  -25  -25  -25   5     5  -25  -25  -25  -25  -25   -25    1    1
1    1    1    1    1    1    1    1   5     5    1    1    1    1    1     1    1    1 
1    1    1    1    1    1    1    1   5     5    1    1    1    1    1     1    1    1
1    1    1    1    1    1    1    1   1     1    1    1    1    1    1     1    1    1
1    1    1    1    1    1    1    1   1     1    1    1    1    1    1     1    1    1
1    1    1    1    1    1    1    1   1     1    1    1    1    1    1     1    1    1
