1 1 1   1   1    1    1    1    1   1 1 1 1
1 1 1   1   1    1    1    1    1   1 1 1 1
1 1 1  500  500  1    1    500  500 1 1 1 1
1 1 1  500  500  1    1    500  500 1 1 1 1
1 1 1  500  500  1    1    500  500 1 1 1 1
1 1 1  500  500  500  500  500  500 1 1 1 1
1 1 1  500  500  500  500  500  500 1 1 1 1
1 1 1   1   1    1    1    500  500 1 1 1 1
1 1 1   1   1    1    1    500  500 1 1 1 1
1 1 1   1   1    1    1    500  500 1 1 1 1
1 1 1   1   1    1    1    500  500 1 1 1 1
1 1 1   1   1    1    1    500  500 1 1 1 1
1 1 1   1   1    1    1    1    1   1 1 1 1
1 1 1   1   1    1    1    1    1   1 1 1 1
1 1 1   1   1    1    1    1    1   1 1 1 1