1  1  1  1  1  1  1  1  1  1  1  1  1  1  1  1  1  1  1  1
1  1  1  1  1  1  1  1  1  1  1  1  1  1  1  1  1  1  1  1
1  1  1  1  1  1  1  1  1  1  1  1  1  1  1  1  1  1  1  1
1  1  1 51 51  1  1  1  1  1  1  1 51 51 51  1  1  1  1  1
1  1  1 51 51  1  1  1  1  1  1  1 51 51 51 51  1  1  1  1
1  1  1 51 51  1  1  1  1  1  1 51 51  1 51 51 51  1  1  1
1  1  1 51 51  1  1  1  1  1  1 51 51  1  1 51 51  1  1  1
1  1  1 51 51  1  1  1  1  1  1 51 51  1  1 51 51  1  1  1
1  1  1 51 51  1  1  1  1  1  1  1  1  1  1 51 51  1  1  1
1  1  1 51 51 51 51 51  1  1  1  1  1  1 51 51 51  1  1  1
1  1  1 51 51 51 51 51  1  1  1  1  1 51 51 51  1  1  1  1
1  1  1 51 51 51 51 51  1  1  1  1 51 51 51  1  1  1  1  1
1  1  1  1  1 51 51  1  1  1  1 51 51 51  1  1  1  1  1  1
1  1  1  1  1 51 51  1  1  1  1 51 51  1  1  1  1  1  1  1
1  1  1  1  1 51 51  1  1  1  1 51 51 51 51 51 51  1  1  1
1  1  1  1  1 51 51  1  1  1  1 51 51 51 51 51 51  1  1  1
1  1  1  1  1 51 51  1  1  1  1 51 51 51 51 51 51  1  1  1
1  1  1  1  1  1  1  1  1  1  1  1  1  1  1  1  1  1  1  1
1  1  1  1  1  1  1  1  1  1  1  1  1  1  1  1  1  1  1  1
1  1  1  1  1  1  1  1  1  1  1  1  1  1  1  1  1  1  1  1