1     1     1     1     1     1     1     1   1   1     1    1     1     1     1    1    1
1     1     1     1     1     1     1     1   1   1     1    1     1     1     1    1    1
1     1     1     1     1     1     1     1   1   1     1    1     1     1     1    1    1
1     1     1     1     1     1     1     1   1   1     1    1     1     1     1    1    1
1     1     1     1    21     1     1     1   1   1     1    1    21     1     1    1    1
1     1     1    21    31    21     1     1   1   1     1   21    31    21     1    1    1
1     1    21    31    41    31    21     1   1   1    21   31    41    31    21    1    1
1     1    21    31    41    31    21     1   1   1    21   31    41    31    21    1    1
1     1    21    31    41    31    21     1   1   1    21   31    41    31    21    1    1
1     1    21    31    41    41    31    21  21  21    31   41    41    31    21    1    1
1     1    21    31    41    51    41    31  31  31    51   51    41    31    21    1    1
1     1    21    31    41    51    61    41  41  41    51   51    41    31    21    1    1
1     1    21    31    41    51    61    51  51  51    51   51    41    31    21    1    1
1     1     1    21    31    41    51    61  61  61    51   41    31    21     1    1    1
1     1     1    21    31    41    51    61  71  61    51   41    31    21     1    1    1
1     1     1    21    31    41    51    61  71  61    51   41    31    21     1    1    1
1     1     1     1    21    31    41    51  71  51    41   31    21     1     1    1    1
1     1     1     1    21    31    41    51  71  51    41   31    21     1     1    1    1
1     1     1     1    21    31    41    51  71  51    41   31    21     1     1    1    1
1     1     1     1     1    21    31    41  71  41    31   21     1     1     1    1    1
1     1     1     1     1    21    31    41  51  41    31   21     1     1     1    1    1
1     1     1     1     1    21    31    41  51  41    31   21     1     1     1    1    1
1     1     1     1     1     1    21    31  41  31    21    1     1     1     1    1    1
1     1     1     1     1     1    21    31  41  31    21    1     1     1     1    1    1
1     1     1     1     1     1    21    31  41  31    21    1     1     1     1    1    1
1     1     1     1     1     1     1    21  31  21     1    1     1     1     1    1    1
1     1     1     1     1     1     1    21  31  21     1    1     1     1     1    1    1
1     1     1     1     1     1     1    21  31  21     1    1     1     1     1    1    1
1     1     1     1     1     1     1    21  31  21     1    1     1     1     1    1    1
1     1     1     1     1     1     1    21  31  21     1    1     1     1     1    1    1
1     1     1     1     1     1     1    21  31  21     1    1     1     1     1    1    1
1     1     1     1     1     1     1    21  31  21     1    1     1     1     1    1    1
1     1     1     1     1     1     1    21  31  21     1    1     1     1     1    1    1
1     1     1     1     1     1     1    21  31  21     1    1     1     1     1    1    1
1     1     1     1     1     1     1    21  31  21     1    1     1     1     1    1    1
1     1     1     1     1     1     1    21  31  21     1    1     1     1     1    1    1
1     1     1     1     1     1     1    21  31  21     1    1     1     1     1    1    1
1     1     1     1     1     1     1    21  31  21     1    1     1     1     1    1    1
1     1     1     1     1     1    21    21  31  21    21    1     1     1     1    1    1
1     1     1     1     1    21    21    31  41  31    21   21     1     1     1    1    1
1     1     1     1     1     1    21    31  41  31    21    1     1     1     1    1    1
1     1     1     1     1     1    21    21  41  21    21    1     1     1     1    1    1
1     1     1     1     1     1     1    21  31  21     1    1     1     1     1    1    1
1     1     1     1     1     1     1    21  21  21     1    1     1     1     1    1    1
1     1     1     1     1     1     1     1  21   1     1    1     1     1     1    1    1
1     1     1     1     1     1     1     1   1   1     1    1     1     1     1    1    1
1     1     1     1     1     1     1     1   1   1     1    1     1     1     1    1    1
1     1     1     1     1     1     1     1   1   1     1    1     1     1     1    1    1