1 1  1  1  1
1 10 10 10 1
1 10 100 10 1
1 10 100 10 1
1 10 100 10 1 
1 10  10  10  1
1 1 1 1 1