1	1	1	1	1	1	1	1	1	1	1	1	1	1	1	1
1	1	1	1	1	1	1	1	1	1	1	1	1	1	1	1
1	1	1	1	50	50	50	50	50	50	50	50	1	1	1	1
1	1	1	50	50	100	100	100	100	100	100	50	50	1	1	1
1	1	50	50	50	100	200	200	200	200	100	50	50	50	1	1
1	1	1	50	50	100	100	100	100	100	100	50	50	1	1	1
1	1	1	1	50	50	50	50	50	50	50	1	1	1	1	1
1	1	1	1	1	1	1	1	1	1	1	1	1	1	1	1
1	1	1	1	1	1	1	1	1	1	1	1	1	1	1	1