1  1   1  1  1  1  1  1   1   1 1
1 100 100 50 50 50 50 50 100 100 1
1 100 100 50 50 50 50 50 100 100 1
1  50  50  0  0  0  0  0  50  50 1
1  50  50  0  0  0  0  0  50  50 1
1  50  50  0  0  0  0  0  50  50 1
1  50  50  0  0  0  0  0  50  50 1
1  50  50  0  0  0  0  0  50  50 1
1  50  50  0  0  0  0  0  50  50 1
1  50  50  0  0  0  0  0  50  50 1
1  50  50  0  0  0  0  0  50  50 1 
1  50  50  0  0  0  0  0  50  50 1
1  50  50  0  0  0  0  0  50  50 1
1  50  50  0  0  0  0  0  50  50 1
1 100 100 50 50 50 50 50 100 100 1
1 100 100 50 50 50 50 50 100 100 1
1 1   1  1  1  1  1  1   1   1 1