40  40  40  40  40  40  40  40  40  40  40  40  40  40  40  40  40 40 40 40 40 40 40 40 40 40
40  40   0   0  40   0   0   0  40   0   0   0   0   0   0   0   0 40 40 40 40  0 40 40  0 40
42  40   0   0   0   0   0  40  40   0   0   0   0   0   0   0   0  0 40 40 40  0  0  0  0 40
40  40   0   0   0   0   0  40  40   0   0   0   0   0   0   0   0  0 40 40 40 40 40 40  0 40
40   0   0  40   0   0  40  40  40   0   0   0   0  40   0   0   0  0 40  0  0  0  0 40  0 40
40   0   0  40  40  40  40  40  40  40   0   0   0   0   0   0   0  0 40  0 40 40  0  0 40 40
40   0  40  40  40   0  40  40  40  40  40   0   0   0   0   0  40 40 40 40 40 40  0 40  0 40
40   0   0  40   0  40  40  40  40  40  40   0   0   0   0   0   0  0 40 40 40 40  0 40  0 40
40  40  40  40  40  40  40  40  40  40  40   0   0   0   0   0   0  0 40 40 40 40  0 40  0 40
40  40  40  40  40  40  40  40   0  40  40   0   0   0   0   0   0  0 40 40  0  0  0 40  0 40
40  40  40  40  40  40  40  40  40  40  40  40   0   0   0   0   0  0 40 40  0 40 40 40  0 40
40  40  40  40  40   0   0   0   0  40  40  40  40  40  40  40  40 40 40 40  0 40  0  0  0 40
 1   0   0   0  40   0  40  40  40  40  40  40  40  40  40  40  40  0 40 40  0  0 40 40  0 40
 1   0   0   0   0   0   0   0   0   0   0   0  40   0  40  40   0  0 40 40 40 40 40 40  0 40
 1   1   1   1  40  40   0   0  40   0  40   0  40   0  40  40   0  0 40 40  0 40 40  0  0 40
40  40  40  40  40   0   0   0  40   0   0   0   0   0  40  40   0 40 40 40  0 40 40  0 40 40
40  40  40   0  40   0  40   0   0   0   0  40   0  40  40  40  40 40 40 40  0  0 40  0 40 40
40  40  40   0  40   0   0   0   0  40  40   0   0   0  40  40   0  0 40 40 40  0  0  0  0 40
40  40  40   0  40  40  40  40   0   0   0   0  40   0  40  40   0  0 40 40 40 40  0 40  0 40
40   0   0   0  40   0   0   0   0   0  40   0   0  40  40  40   0  0 40 40  0  0  0 40  0 40
40   0  40  40  40   0  40   0   0   0   0   0  40   0  40  40   0  0 40 40  0 40 40 40  0 40
40   0   0   0   0   0   0   0  40  40   0   0   0   0  40  40  40  0 40 40  0  0  0  0  0 40
40  40  40  40  40  40  40  40  40  40  40  40  40  40  40  40  40  0 40 40 40  0  0 40 40 40
40  40  40  40  40  40  40  40  40  40  40  40  40  40  40  40   0  0 40 40  0  0 40 40 40 40
40  40  40  40  40   0   0   0  40  40  40  40   0  40  40   0  40 40 40 40 40 40 40 40 40 40
40   0   0  40  40   0  40   0  40  40  40  40   0  40  40   0  40 40 40 40  0  0 40  0 40 40
40  40   0   0  40   0   0   0  40   1   1   1   0   1  40  40  40 40 40 40 40 40 40 40 40 40
40  40  40  40  40  40   0  40  40   1  40   0   0   1  40   0  40  0 40 40  0  0 40  0  0 40
40  40  40  40  40  40  40  40  40   1  40   1   1  40  40   0  40  0 40 40  0 40  0 40  0 40
40  40  40  40  40   0   0  40   1   1  40  40   1  40  40   0  40  0 40 40  0 40  0 40  0 40
40   0   0   0   0   0   0  40   1  40   0   0   1  40   0   0  40  40 40 40 40 40 40 40 40 40
40  40   0   0  40  40  40  40   1  40  40   0  40   0   0   0  40  0 40 40  0  0 40  0  0 40
40   0   0  40  40  40   1   1   1   0   0   0   1  40  40  40  40  0 40 40 40 40  0 40 40 40
40   0   0   0  40  40   1  40  40  40   0  40   1  40  40   0   0  0 40 40 40 40 40 40 40 40
40  40   0   0  40  40  40  40   0   0   0   0   1  40  40  40   0  0 40 40 40 40 40  40 40 40
40  40  40   0  40  40  40   0   0   0   0  40   1  40  40   0   0  0 40 40 40 40 40 40 40 40
40  40  40  40  40   1  40   1   1   1   1   1   1  40  40  40  40 40 40 40 40 40 40 40 40 40
