10
.......o.o
......o...
.....ooo..
..........
...oo.....
........oo
..........
..........
..........
..........
