10
..........
...oo...oo
...oo.....
..........
..........
..........
..........
.......o..
..........
..o.......
