10
.......o..
......oo..
........oo
....o..o.o
..o.......
..........
..........
...oo.....
..........
.......o..
