10
.o....oo..
.......o..
..........
......oo.o
......o..o
...o......
.......o..
o.........
o..o......
..........
