10
....o.....
.....o....
......o...
.oo.......
..........
....o..o..
..........
..oo......
..........
o.........
